001 010 000 001 000 000 010 100 000 000 000 000 000 000 000 000 000 000 000 000
//A BBB CCC DDD EEE FFF GGG HHH III JJJ KKK LLL MMM NNN OOO PPP QQQ RRR SSS TTT
001 001 001 001 001 001 001 001 001 000 000 010 000 000 000 001 001 001 001 001
001 001 001 001 001 001 001 001 001 000 001 001 001 001 000 001 001 001 001 001
001 001 001 001 001 000 001 001 001 000 001 001 001 001 000 000 000 000 000 000
001 001 001 001 001 000 000 000 000 000 001 001 001 001 001 001 001 001 001 001
001 001 001 001 001 000 001 001 001 000 001 001 001 001 001 001 000 000 000 000
001 001 001 001 001 010 001 001 001 000 001 001 001 000 000 000 000 001 001 001
000 000 000 000 000 000 001 001 001 000 000 000 000 000 001 001 001 001 001 001
000 001 001 001 001 000 000 000 001 001 001 001 001 000 001 010 000 000 010 000
000 001 001 001 001 001 001 010 001 001 001 001 001 000 001 001 001 000 001 001
111 001 001 001 001 000 000 000 000 000 000 000 001 000 000 000 000 000 001 001
//A BBB CCC DDD EEE FFF GGG HHH III JJJ KKK LLL MMM NNN OOO PPP QQQ RRR SSS TTT